1111111111111111111111111111111
1000111000101101001011010101111
1010111110001001110011010101011
1010010100100101001010010010101
1001010010100101000100100101011
1001001001001001000011111100111
11010101010E1001010010101001011
1010100100101001000011111010101
1010101010101001001001010100101
1111111111111111111111111111111